<?xml version='1.0' encoding='utf-8'?>
<map>
  <terrain x='33' y='33'>
    <heightmap>
      <layermask>011001111221232241122310011221221
011111111212233342233321022322221
011011112222325333352222023222230
011011112212133333344322132222331
011111122222133333451112034332211
111221112111133334321111124333100
011221111211133333211112112222000
112211112410132222111222111111000
112111111110111112232301111122110
012111110310000111233022321211111
022121100100000012420033313211111
022211111100000022410003212211111
111111101100000123310001112211111
122211211100001222100000112321100
000001311000001111100111122112100
000112311100011101011111211111100
001111111111111131111110221111100
001100111111112211111110221111100
000110111121111111112100221111000
001121111211111111222100111100000
001111111111212211221111100000000
000001111112212211212111000000000
000010101112112211122320000000000
000111010101111011123320000000000
000111001010000011113210000000000
000000000111100121111110000000000
000000111111101121111100000000000
000001111111111101111000000000000
000001101111111100000000000000000
000010011111111100000000000000000
011221222221111100000000000000000
112221322221111000000000000000000
112221322210000000000000000000000</layermask>
    </heightmap>
    <layers>
      <layer id='0' />
      <layer id='1'>
        <layermask>001000000110111011111111000000000
010000000111111111111111110000000
011000001111111111111111111010000
010000001111101111111111111111110
000000011111011111111111111111110
000110001000111111111111111111110
000110011011111111111111111111110
001100001111111111111111111111110
101000011111111111111111111111110
101000111111111111111111111111100
011011111111111111111111111111000
011101111111111111111111111111000
000001111111111111111111111111000
011111111111111111111111111100000
000011111111111111111111111100000
000011111111111111111111111100000
000011111111111111111111111100000
000011111111111111111111111000000
000011111111111011111111111000000
000011111111111111111111111000000
000011111111111111111111111000000
000001111111111111111111111000000
000011111111111111111111111000000
000011111111111111111111100000000
000011111111111111111111100000000
000011111111001111111111100000000
000011111110000001111111100000000
000011111111000001111111000000000
000011111111000001111100000000000
000011111111000000001000000000000
000011111111000000000000000000000
000001111100000000000000000000000
000000001000000000000000000000000</layermask>
      </layer>
    </layers>
  </terrain>
</map>